15
. . . . . . . . . . . . . . . . . . . . . . . . . . . . .
. . . . . . . .*************** . . . . . . . . / / / / / 
. . .*. . . . . . . . . . . . . . . . . . . . . . . . . .
. . .** . . . . . . . . . . . . . . . . . . . . . . . . . 
. . .** . . . . . . . . . . . . . . . . . . . . . . . . . 
. . .** . . . . . . . . . . . . . . . . . . . . . . . . . 
. . .** . . . . . . . . . . **************. . . . . . . . 
. . .************** . . . . . . . . . . . . . . . . . . . 
. . .** . . . . . . . . . . . . . . . . . . . . . . . . .
. . .** . . . . . . . . . . . . . . . . . . . . . . . . .
. . .** . . . . . . . . . . . . . . . . . . . . . . . . .
. . .** . . . . . . . . . . . . . . . . . . . . . . . . .
. . . . . . . . . . . . .************************ . . . .
. . . . . . . . . . . . . . . . . . . . . . . . . . . . .
. . . . . . . . . . . . . . . . . . . . . . . . . . . . .


